MMMMMMMMMMMMMMM
M       B     M
M      A      M
M             M
M             M
M             M
M             M
M      D      M
M     B       M
MMMMMMMMMMMMMMM