D.M......M..0.0
.  M    M     .
0   M  M 0  M .
. M        M0 .
.M   M    M   M
M0    M0     M.
.  M   M 0  M .
. M    0M M   0
.M  0  M   M  .
.. ......0....A