...DM...0.....A
.MMMMM 0  0MMMM
.      MM    0.
0  M 1   0MM  .
.     0  0    .
MM00    M   M0M
2    0MMM  00 1
MMMM0 M 0   MMM
3  M    MM0   3
.0....0.2M...0.