D....00......00
.            00
MMMMMMMM  00  .
.      M  00  .
.00           .
.00  MMMMM00MMM
.             .
MMMM  MMMMM000.
00         000.
00..00..MM....A