MMM...M..A..M2.
.M   MMM   MMM.
1  2  M  M0 M .
 M    0 MMM   M
MMM  M   M   MM
.M0 MMM    1 0M
D    M 0 M    .
 M      MMM  M.
MMM 0M  0M  MMM
.M..MMM.....0M.