...............
.             .
. 1  M    M   .
.       1     .
.    M    M   .
.D           A.
.    M    M   .
.       2     .
.    M    M   .
..2............