D...M0M.......1
M0       M0M  .
.  M0M       M0
1      2 M0M  .
. M0M        M0
.      M0M    .
M0M        M0M.
.   M0M       .
0M      M0M M0M
2...M0M.......A