...............
.             .
.             .
.           0 .
.         0   0
.D          A .
.         0   0
.           0 .
.             .
...............