MM........MD..0
M   MM0   MM  .
.   0M       MM
1   MB  MM0   M
MM  MM   M    B
M      M     0M
. 00  MM MM  MM
.        M    .
. MM   M   MM0.
A.M1..MM0...M..