D...M........MM
M       M    0M
M   M 0 MMM   .
1 00M 0 M     0
MMMMMM  M  M  .
. 0  M  B   MMM
0    MMMMMM   M
M  M         0M
M  MMMM  0MM  .
A..M1..B..MM..B