..AM.2M..0...M1
. M0  M      M.
.     M   0M  .
.0         M  .
MM    M    B MM
.  B  M   M   0
M  0  M  0MM  .
.M        M1M2.
. M0  M   M  M.
......M0......D