D..0M..........
.   M  0MMM  M.
MMM M        M.
1      MMMMMMM.
M MMM         .
.  0M  MMM  M0.
M   M  M    M .
M       2M  M 1
M0  M  MMM  MMM
2...M.........A