..........00...
.         00 A.
.      MMM    .
.  M         00
.  M    0    00
.  MB  0  MMM .
.         B   .
.      M      .
.D     M      .
...... M.......