1........M.....
.     0  M   A.
. 00          .
. 00      MMMMM
.     M0      .
.      0M     .
MMMMM      00 .
.          00 .
.D   M  0     .
.....M........1