0.............A
0  MMMMMMMM00MM
M    0M      M.
M MM     M   M.
M    0MMMM0  M.
MMMMMMM       .
M 00     M    0
.      MMM  0 .
.D MMM   M  0 .
.......M....M..