....M0.A.0M....
.             .
M 0 MM 0 MM 0 M
M 0 MM 0 MM 0 M
0             0
.  M  MMM  M  .
.MMM  M M  MMM.
.M M0 M M 0M M.
.MMM  MMM  MMM.
.......D.......