D.MMM..M0.....M
.     0M  MM0 M
M MMM  M    M M
M MMM  MMM0 M M
M MMM0   M  M M
.   0MMM M  M .
.0   MMM M 0M .
MMMM MMM M  M0.
.           M .
MMMMMMMMMMMMM.A